"i","t","p","q","pi","Q_other","Q","player_type"
1,1,0,20,-20,87,107,"PRO"
1,2,50,5,245,45,50,"PRO"
1,3,45,5,220,50,55,"PRO"
1,4,30,7,203,63,70,"PRO"
1,5,52,5,255,43,48,"PRO"
1,6,31,7,210,62,69,"PRO"
1,7,42,5,205,53,58,"PRO"
1,8,31,4,120,65,69,"PRO"
1,9,33,10,320,57,67,"PRO"
1,10,8,15,105,77,92,"PRO"
1,11,43,5,210,52,57,"PRO"
1,12,34,5,165,61,66,"PRO"
1,13,35,10,340,55,65,"PRO"
1,14,27,12,312,61,73,"PRO"
1,15,37,10,360,53,63,"PRO"
1,16,33,10,320,57,67,"PRO"
1,17,37,8,288,55,63,"PRO"
1,18,36,8,280,56,64,"PRO"
1,19,38,7,259,55,62,"PRO"
1,20,36,8,280,56,64,"PRO"
1,21,34,10,330,56,66,"PRO"
1,22,33,12,384,55,67,"PRO"
1,23,33,13,416,54,67,"PRO"
1,24,32,14,434,54,68,"PRO"
1,25,35,15,510,50,65,"PRO"
2,1,0,20,-20,87,107,"PRO"
2,2,50,5,245,45,50,"PRO"
2,3,45,15,660,40,55,"PRO"
2,4,30,20,580,50,70,"PRO"
2,5,52,10,510,38,48,"PRO"
2,6,31,15,450,54,69,"PRO"
2,7,42,10,410,48,58,"PRO"
2,8,31,12,360,57,69,"PRO"
2,9,33,10,320,57,67,"PRO"
2,10,8,25,175,67,92,"PRO"
2,11,43,12,504,45,57,"PRO"
2,12,34,12,396,54,66,"PRO"
2,13,35,10,340,55,65,"PRO"
2,14,27,11,286,62,73,"PRO"
2,15,37,10,360,53,63,"PRO"
2,16,33,11,352,56,67,"PRO"
2,17,37,10,360,53,63,"PRO"
2,18,36,10,350,54,64,"PRO"
2,19,38,9,333,53,62,"PRO"
2,20,36,8,280,56,64,"PRO"
2,21,34,9,297,57,66,"PRO"
2,22,33,8,256,59,67,"PRO"
2,23,33,7,224,60,67,"PRO"
2,24,32,6,186,62,68,"PRO"
2,25,35,2,68,63,65,"PRO"
3,1,0,20,-20,87,107,"PRO"
3,2,50,10,490,40,50,"PRO"
3,3,45,10,440,45,55,"PRO"
3,4,30,8,232,62,70,"PRO"
3,5,52,8,408,40,48,"PRO"
3,6,31,10,300,59,69,"PRO"
3,7,42,8,328,50,58,"PRO"
3,8,31,8,240,61,69,"PRO"
3,9,33,7,224,60,67,"PRO"
3,10,8,6,42,86,92,"PRO"
3,11,43,5,210,52,57,"PRO"
3,12,34,6,198,60,66,"PRO"
3,13,35,5,170,60,65,"PRO"
3,14,27,4,104,69,73,"PRO"
3,15,37,3,108,60,63,"PRO"
3,16,33,3,96,64,67,"PRO"
3,17,37,2,72,61,63,"PRO"
3,18,36,1,35,63,64,"PRO"
3,19,38,1,37,61,62,"PRO"
3,20,36,2,70,62,64,"PRO"
3,21,34,1,33,65,66,"PRO"
3,22,33,2,64,65,67,"PRO"
3,23,33,3,96,64,67,"PRO"
3,24,32,3,93,65,68,"PRO"
3,25,35,2,68,63,65,"PRO"
4,1,0,20,-20,87,107,"PRO"
4,2,50,10,490,40,50,"PRO"
4,3,45,15,660,40,55,"PRO"
4,4,30,20,580,50,70,"PRO"
4,5,52,15,765,33,48,"PRO"
4,6,31,17,510,52,69,"PRO"
4,7,42,15,615,43,58,"PRO"
4,8,31,15,450,54,69,"PRO"
4,9,33,12,384,55,67,"PRO"
4,10,8,17,119,75,92,"PRO"
4,11,43,10,420,47,57,"PRO"
4,12,34,15,495,51,66,"PRO"
4,13,35,12,408,53,65,"PRO"
4,14,27,18,468,55,73,"PRO"
4,15,37,12,432,51,63,"PRO"
4,16,33,15,480,52,67,"PRO"
4,17,37,15,540,48,63,"PRO"
4,18,36,17,595,47,64,"PRO"
4,19,38,17,629,45,62,"PRO"
4,20,36,18,630,46,64,"PRO"
4,21,34,18,594,48,66,"PRO"
4,22,33,17,544,50,67,"PRO"
4,23,33,16,512,51,67,"PRO"
4,24,32,17,527,51,68,"PRO"
4,25,35,18,612,47,65,"PRO"
5,1,0,27,-27,80,107,"FLASH"
5,2,50,20,980,30,50,"FLASH"
5,3,45,10,440,45,55,"FLASH"
5,4,30,15,435,55,70,"FLASH"
5,5,52,10,510,38,48,"FLASH"
5,6,31,20,600,49,69,"FLASH"
5,7,42,20,820,38,58,"FLASH"
5,8,31,30,900,39,69,"FLASH"
5,9,33,28,896,39,67,"FLASH"
5,10,8,29,203,63,92,"FLASH"
5,11,43,25,1050,32,57,"FLASH"
5,12,34,28,924,38,66,"FLASH"
5,13,35,28,952,37,65,"FLASH"
5,14,27,28,728,45,73,"FLASH"
5,15,37,28,1008,35,63,"FLASH"
5,16,33,28,896,39,67,"FLASH"
5,17,37,28,1008,35,63,"FLASH"
5,18,36,28,980,36,64,"FLASH"
5,19,38,28,1036,34,62,"FLASH"
5,20,36,28,980,36,64,"FLASH"
5,21,34,28,924,38,66,"FLASH"
5,22,33,28,896,39,67,"FLASH"
5,23,33,28,896,39,67,"FLASH"
5,24,32,28,868,40,68,"FLASH"
5,25,35,28,952,37,65,"FLASH"
1,1,0,25,-25,80,105,"FLASH"
1,2,45,20,880,35,55,"FLASH"
1,3,20,20,380,60,80,"FLASH"
1,4,36,20,700,44,64,"FLASH"
1,5,34,20,660,46,66,"FLASH"
1,6,28,20,540,52,72,"FLASH"
1,7,32,20,620,48,68,"FLASH"
1,8,27,20,520,53,73,"FLASH"
1,9,30,20,580,50,70,"FLASH"
1,10,31,20,600,49,69,"FLASH"
1,11,33,20,640,47,67,"FLASH"
1,12,29,20,560,51,71,"FLASH"
1,13,28,20,540,52,72,"FLASH"
1,14,31,20,600,49,69,"FLASH"
1,15,28,20,540,52,72,"FLASH"
1,16,30,20,580,50,70,"FLASH"
1,17,28,20,540,52,72,"FLASH"
1,18,27,20,520,53,73,"FLASH"
1,19,30,20,580,50,70,"FLASH"
1,20,27,20,520,53,73,"FLASH"
1,21,32,20,620,48,68,"FLASH"
1,22,32,20,620,48,68,"FLASH"
1,23,29,20,560,51,71,"FLASH"
1,24,33,20,640,47,67,"FLASH"
1,25,31,20,600,49,69,"FLASH"
2,1,0,20,-20,85,105,"PRO"
2,2,45,10,440,45,55,"PRO"
2,3,20,20,380,60,80,"PRO"
2,4,36,15,525,49,64,"PRO"
2,5,34,12,396,54,66,"PRO"
2,6,28,15,405,57,72,"PRO"
2,7,32,12,372,56,68,"PRO"
2,8,27,10,260,63,73,"PRO"
2,9,30,8,232,62,70,"PRO"
2,10,31,6,180,63,69,"PRO"
2,11,33,0,0,67,67,"PRO"
2,12,29,0,0,71,71,"PRO"
2,13,28,5,135,67,72,"PRO"
2,14,31,5,150,64,69,"PRO"
2,15,28,7,189,65,72,"PRO"
2,16,30,5,145,65,70,"PRO"
2,17,28,5,135,67,72,"PRO"
2,18,27,7,182,66,73,"PRO"
2,19,30,5,145,65,70,"PRO"
2,20,27,6,156,67,73,"PRO"
2,21,32,5,155,63,68,"PRO"
2,22,32,4,124,64,68,"PRO"
2,23,29,6,168,65,71,"PRO"
2,24,33,5,160,62,67,"PRO"
2,25,31,5,150,64,69,"PRO"
3,1,0,20,-20,85,105,"PRO"
3,2,45,5,220,50,55,"PRO"
3,3,20,10,190,70,80,"PRO"
3,4,36,7,245,57,64,"PRO"
3,5,34,5,165,61,66,"PRO"
3,6,28,10,270,62,72,"PRO"
3,7,32,12,372,56,68,"PRO"
3,8,27,15,390,58,73,"PRO"
3,9,30,18,522,52,70,"PRO"
3,10,31,20,600,49,69,"PRO"
3,11,33,22,704,45,67,"PRO"
3,12,29,24,672,47,71,"PRO"
3,13,28,22,594,50,72,"PRO"
3,14,31,20,600,49,69,"PRO"
3,15,28,21,567,51,72,"PRO"
3,16,30,20,580,50,70,"PRO"
3,17,28,19,513,53,72,"PRO"
3,18,27,20,520,53,73,"PRO"
3,19,30,21,609,49,70,"PRO"
3,20,27,22,572,51,73,"PRO"
3,21,32,21,651,47,68,"PRO"
3,22,32,21,651,47,68,"PRO"
3,23,29,20,560,51,71,"PRO"
3,24,33,19,608,48,67,"PRO"
3,25,31,20,600,49,69,"PRO"
4,1,0,20,-20,85,105,"PRO"
4,2,45,5,220,50,55,"PRO"
4,3,20,15,285,65,80,"PRO"
4,4,36,10,350,54,64,"PRO"
4,5,34,15,495,51,66,"PRO"
4,6,28,17,459,55,72,"PRO"
4,7,32,12,372,56,68,"PRO"
4,8,27,14,364,59,73,"PRO"
4,9,30,12,348,58,70,"PRO"
4,10,31,12,360,57,69,"PRO"
4,11,33,13,416,54,67,"PRO"
4,12,29,14,392,57,71,"PRO"
4,13,28,13,351,59,72,"PRO"
4,14,31,11,330,58,69,"PRO"
4,15,28,12,324,60,72,"PRO"
4,16,30,11,319,59,70,"PRO"
4,17,28,13,351,59,72,"PRO"
4,18,27,12,312,61,73,"PRO"
4,19,30,11,319,59,70,"PRO"
4,20,27,12,312,61,73,"PRO"
4,21,32,10,310,58,68,"PRO"
4,22,32,11,341,57,68,"PRO"
4,23,29,12,336,59,71,"PRO"
4,24,33,11,352,56,67,"PRO"
4,25,31,12,360,57,69,"PRO"
5,1,0,20,-20,85,105,"PRO"
5,2,45,15,660,40,55,"PRO"
5,3,20,15,285,65,80,"PRO"
5,4,36,12,420,52,64,"PRO"
5,5,34,14,462,52,66,"PRO"
5,6,28,10,270,62,72,"PRO"
5,7,32,12,372,56,68,"PRO"
5,8,27,14,364,59,73,"PRO"
5,9,30,12,348,58,70,"PRO"
5,10,31,11,330,58,69,"PRO"
5,11,33,12,384,55,67,"PRO"
5,12,29,13,364,58,71,"PRO"
5,13,28,12,324,60,72,"PRO"
5,14,31,13,390,56,69,"PRO"
5,15,28,12,324,60,72,"PRO"
5,16,30,14,406,56,70,"PRO"
5,17,28,15,405,57,72,"PRO"
5,18,27,14,364,59,73,"PRO"
5,19,30,13,377,57,70,"PRO"
5,20,27,13,338,60,73,"PRO"
5,21,32,12,372,56,68,"PRO"
5,22,32,12,372,56,68,"PRO"
5,23,29,13,364,58,71,"PRO"
5,24,33,12,384,55,67,"PRO"
5,25,31,12,360,57,69,"PRO"
1,1,0,20,-20,85,105,"PRO"
1,2,60,5,295,35,40,"PRO"
1,3,20,20,380,60,80,"PRO"
1,4,42,10,410,48,58,"PRO"
1,5,35,15,510,50,65,"PRO"
1,6,34,18,594,48,66,"PRO"
1,7,27,20,520,53,73,"PRO"
1,8,28,17,459,55,72,"PRO"
1,9,30,15,435,55,70,"PRO"
1,10,30,12,348,58,70,"PRO"
1,11,26,14,350,60,74,"PRO"
1,12,26,16,400,58,74,"PRO"
1,13,28,18,486,54,72,"PRO"
1,14,15,19,266,66,85,"PRO"
1,15,25,17,408,58,75,"PRO"
1,16,22,18,378,60,78,"PRO"
1,17,41,16,640,43,59,"PRO"
1,18,30,16,464,54,70,"PRO"
1,19,40,17,663,43,60,"PRO"
1,20,37,17,612,46,63,"PRO"
1,21,40,18,702,42,60,"PRO"
1,22,37,19,684,44,63,"PRO"
1,23,24,19,437,57,76,"PRO"
1,24,30,17,493,53,70,"PRO"
1,25,38,16,592,46,62,"PRO"
2,1,0,25,-25,80,105,"FLASH"
2,2,60,20,1180,20,40,"FLASH"
2,3,20,20,380,60,80,"FLASH"
2,4,42,20,820,38,58,"FLASH"
2,5,35,20,680,45,65,"FLASH"
2,6,34,20,660,46,66,"FLASH"
2,7,27,20,520,53,73,"FLASH"
2,8,28,20,540,52,72,"FLASH"
2,9,30,20,580,50,70,"FLASH"
2,10,30,20,580,50,70,"FLASH"
2,11,26,20,500,54,74,"FLASH"
2,12,26,20,500,54,74,"FLASH"
2,13,28,20,540,52,72,"FLASH"
2,14,15,30,420,55,85,"FLASH"
2,15,25,30,720,45,75,"FLASH"
2,16,22,30,630,48,78,"FLASH"
2,17,41,20,800,39,59,"FLASH"
2,18,30,30,870,40,70,"FLASH"
2,19,40,20,780,40,60,"FLASH"
2,20,37,20,720,43,63,"FLASH"
2,21,40,20,780,40,60,"FLASH"
2,22,37,20,720,43,63,"FLASH"
2,23,24,30,690,46,76,"FLASH"
2,24,30,30,870,40,70,"FLASH"
2,25,38,20,740,42,62,"FLASH"
3,1,0,20,-20,85,105,"PRO"
3,2,60,5,295,35,40,"PRO"
3,3,20,15,285,65,80,"PRO"
3,4,42,10,410,48,58,"PRO"
3,5,35,10,340,55,65,"PRO"
3,6,34,8,264,58,66,"PRO"
3,7,27,8,208,65,73,"PRO"
3,8,28,10,270,62,72,"PRO"
3,9,30,9,261,61,70,"PRO"
3,10,30,9,261,61,70,"PRO"
3,11,26,8,200,66,74,"PRO"
3,12,26,9,225,65,74,"PRO"
3,13,28,8,216,64,72,"PRO"
3,14,15,8,112,77,85,"PRO"
3,15,25,7,168,68,75,"PRO"
3,16,22,7,147,71,78,"PRO"
3,17,41,6,240,53,59,"PRO"
3,18,30,5,145,65,70,"PRO"
3,19,40,7,273,53,60,"PRO"
3,20,37,7,252,56,63,"PRO"
3,21,40,6,234,54,60,"PRO"
3,22,37,5,180,58,63,"PRO"
3,23,24,6,138,70,76,"PRO"
3,24,30,5,145,65,70,"PRO"
3,25,38,6,222,56,62,"PRO"
4,1,0,20,-20,85,105,"PRO"
4,2,60,5,295,35,40,"PRO"
4,3,20,10,190,70,80,"PRO"
4,4,42,8,328,50,58,"PRO"
4,5,35,10,340,55,65,"PRO"
4,6,34,12,396,54,66,"PRO"
4,7,27,13,338,60,73,"PRO"
4,8,28,11,297,61,72,"PRO"
4,9,30,10,290,60,70,"PRO"
4,10,30,11,319,59,70,"PRO"
4,11,26,12,300,62,74,"PRO"
4,12,26,11,275,63,74,"PRO"
4,13,28,10,270,62,72,"PRO"
4,14,15,11,154,74,85,"PRO"
4,15,25,9,216,66,75,"PRO"
4,16,22,9,189,69,78,"PRO"
4,17,41,7,280,52,59,"PRO"
4,18,30,9,261,61,70,"PRO"
4,19,40,8,312,52,60,"PRO"
4,20,37,9,324,54,63,"PRO"
4,21,40,8,312,52,60,"PRO"
4,22,37,10,360,53,63,"PRO"
4,23,24,11,253,65,76,"PRO"
4,24,30,10,290,60,70,"PRO"
4,25,38,11,407,51,62,"PRO"
5,1,0,20,-20,85,105,"PRO"
5,2,60,5,295,35,40,"PRO"
5,3,20,15,285,65,80,"PRO"
5,4,42,10,410,48,58,"PRO"
5,5,35,10,340,55,65,"PRO"
5,6,34,8,264,58,66,"PRO"
5,7,27,12,312,61,73,"PRO"
5,8,28,14,378,58,72,"PRO"
5,9,30,16,464,54,70,"PRO"
5,10,30,18,522,52,70,"PRO"
5,11,26,20,500,54,74,"PRO"
5,12,26,18,450,56,74,"PRO"
5,13,28,16,432,56,72,"PRO"
5,14,15,17,238,68,85,"PRO"
5,15,25,12,288,63,75,"PRO"
5,16,22,14,294,64,78,"PRO"
5,17,41,10,400,49,59,"PRO"
5,18,30,10,290,60,70,"PRO"
5,19,40,8,312,52,60,"PRO"
5,20,37,10,360,53,63,"PRO"
5,21,40,8,312,52,60,"PRO"
5,22,37,9,324,54,63,"PRO"
5,23,24,10,230,66,76,"PRO"
5,24,30,8,232,62,70,"PRO"
5,25,38,9,333,53,62,"PRO"
1,1,0,20,-20,85,105,"PRO"
1,2,50,5,245,45,50,"PRO"
1,3,25,15,360,60,75,"PRO"
1,4,46,10,450,44,54,"PRO"
1,5,49,10,480,41,51,"PRO"
1,6,46,8,360,46,54,"PRO"
1,7,41,10,400,49,59,"PRO"
1,8,49,9,432,42,51,"PRO"
1,9,45.5,9.5,422.75,45,54.5,"PRO"
1,10,47,10,460,43,53,"PRO"
1,11,46,11,495,43,54,"PRO"
1,12,42.5,11.5,477.25,46,57.5,"PRO"
1,13,46,11,495,43,54,"PRO"
1,14,45,11,484,44,55,"PRO"
1,15,48.5,10.5,498.75,41,51.5,"PRO"
1,16,48,10,470,42,52,"PRO"
1,17,47.5,10.5,488.25,42,52.5,"PRO"
1,18,46,11,495,43,54,"PRO"
1,19,48.5,10.5,498.75,41,51.5,"PRO"
1,20,48.5,10.5,498.75,41,51.5,"PRO"
1,21,46,10,450,44,54,"PRO"
1,22,46.5,10.5,477.75,43,53.5,"PRO"
1,23,45.5,10.5,467.25,44,54.5,"PRO"
1,24,44,11,473,45,56,"PRO"
1,25,46.5,10.5,477.75,43,53.5,"PRO"
2,1,0,25,-25,80,105,"FLASH"
2,2,50,20,980,30,50,"FLASH"
2,3,25,15,360,60,75,"FLASH"
2,4,46,10,450,44,54,"FLASH"
2,5,49,5,240,46,51,"FLASH"
2,6,46,10,450,44,54,"FLASH"
2,7,41,10,400,49,59,"FLASH"
2,8,49,10,480,41,51,"FLASH"
2,9,45.5,10,445,44.5,54.5,"FLASH"
2,10,47,10,460,43,53,"FLASH"
2,11,46,10,450,44,54,"FLASH"
2,12,42.5,10,415,47.5,57.5,"FLASH"
2,13,46,10,450,44,54,"FLASH"
2,14,45,10,440,45,55,"FLASH"
2,15,48.5,10,475,41.5,51.5,"FLASH"
2,16,48,10,470,42,52,"FLASH"
2,17,47.5,10,465,42.5,52.5,"FLASH"
2,18,46,10,450,44,54,"FLASH"
2,19,48.5,7,332.5,44.5,51.5,"FLASH"
2,20,48.5,7,332.5,44.5,51.5,"FLASH"
2,21,46,7,315,47,54,"FLASH"
2,22,46.5,7,318.5,46.5,53.5,"FLASH"
2,23,45.5,7,311.5,47.5,54.5,"FLASH"
2,24,44,7,301,49,56,"FLASH"
2,25,46.5,7,318.5,46.5,53.5,"FLASH"
3,1,0,20,-20,85,105,"PRO"
3,2,50,5,245,45,50,"PRO"
3,3,25,15,360,60,75,"PRO"
3,4,46,10,450,44,54,"PRO"
3,5,49,12,576,39,51,"PRO"
3,6,46,10,450,44,54,"PRO"
3,7,41,12,480,47,59,"PRO"
3,8,49,8,384,43,51,"PRO"
3,9,45.5,10,445,44.5,54.5,"PRO"
3,10,47,10,460,43,53,"PRO"
3,11,46,9,405,45,54,"PRO"
3,12,42.5,10,415,47.5,57.5,"PRO"
3,13,46,9,405,45,54,"PRO"
3,14,45,10,440,45,55,"PRO"
3,15,48.5,9,427.5,42.5,51.5,"PRO"
3,16,48,10,470,42,52,"PRO"
3,17,47.5,11,511.5,41.5,52.5,"PRO"
3,18,46,12,540,42,54,"PRO"
3,19,48.5,13,617.5,38.5,51.5,"PRO"
3,20,48.5,14,665,37.5,51.5,"PRO"
3,21,46,15,675,39,54,"PRO"
3,22,46.5,14,637,39.5,53.5,"PRO"
3,23,45.5,13,578.5,41.5,54.5,"PRO"
3,24,44,14,602,42,56,"PRO"
3,25,46.5,13,591.5,40.5,53.5,"PRO"
4,1,0,20,-20,85,105,"PRO"
4,2,50,10,490,40,50,"PRO"
4,3,25,15,360,60,75,"PRO"
4,4,46,12,540,42,54,"PRO"
4,5,49,10,480,41,51,"PRO"
4,6,46,10,450,44,54,"PRO"
4,7,41,9,360,50,59,"PRO"
4,8,49,8,384,43,51,"PRO"
4,9,45.5,8,356,46.5,54.5,"PRO"
4,10,47,7,322,46,53,"PRO"
4,11,46,9,405,45,54,"PRO"
4,12,42.5,10,415,47.5,57.5,"PRO"
4,13,46,9,405,45,54,"PRO"
4,14,45,9,396,46,55,"PRO"
4,15,48.5,8,380,43.5,51.5,"PRO"
4,16,48,8,376,44,52,"PRO"
4,17,47.5,8,372,44.5,52.5,"PRO"
4,18,46,7,315,47,54,"PRO"
4,19,48.5,8,380,43.5,51.5,"PRO"
4,20,48.5,8,380,43.5,51.5,"PRO"
4,21,46,9,405,45,54,"PRO"
4,22,46.5,8,364,45.5,53.5,"PRO"
4,23,45.5,9,400.5,45.5,54.5,"PRO"
4,24,44,8,344,48,56,"PRO"
4,25,46.5,7,318.5,46.5,53.5,"PRO"
5,1,0,20,-20,85,105,"PRO"
5,2,50,10,490,40,50,"PRO"
5,3,25,15,360,60,75,"PRO"
5,4,46,12,540,42,54,"PRO"
5,5,49,14,672,37,51,"PRO"
5,6,46,16,720,38,54,"PRO"
5,7,41,18,720,41,59,"PRO"
5,8,49,16,768,35,51,"PRO"
5,9,45.5,17,756.5,37.5,54.5,"PRO"
5,10,47,16,736,37,53,"PRO"
5,11,46,15,675,39,54,"PRO"
5,12,42.5,16,664,41.5,57.5,"PRO"
5,13,46,15,675,39,54,"PRO"
5,14,45,15,660,40,55,"PRO"
5,15,48.5,14,665,37.5,51.5,"PRO"
5,16,48,14,658,38,52,"PRO"
5,17,47.5,13,604.5,39.5,52.5,"PRO"
5,18,46,14,630,40,54,"PRO"
5,19,48.5,13,617.5,38.5,51.5,"PRO"
5,20,48.5,12,570,39.5,51.5,"PRO"
5,21,46,13,585,41,54,"PRO"
5,22,46.5,14,637,39.5,53.5,"PRO"
5,23,45.5,15,667.5,39.5,54.5,"PRO"
5,24,44,16,688,40,56,"PRO"
5,25,46.5,16,728,37.5,53.5,"PRO"
1,1,0,20,-20,80,100,"PRO"
1,2,35,5,170,60,65,"PRO"
1,3,15,10,140,75,85,"PRO"
1,4,48,7,329,45,52,"PRO"
1,5,31,10,300,59,69,"PRO"
1,6,49,8,384,43,51,"PRO"
1,7,39,9,342,52,61,"PRO"
1,8,41,7,280,52,59,"PRO"
1,9,40,8,312,52,60,"PRO"
1,10,37,9,324,54,63,"PRO"
1,11,26,8,200,66,74,"PRO"
1,12,49,7,336,44,51,"PRO"
1,13,46,8,360,46,54,"PRO"
1,14,41,9,360,50,59,"PRO"
1,15,40,10,390,50,60,"PRO"
1,16,40,11,429,49,60,"PRO"
1,17,38,12,444,50,62,"PRO"
1,18,37,13,468,50,63,"PRO"
1,19,34,14,462,52,66,"PRO"
1,20,39,12,456,49,61,"PRO"
1,21,35.5,13.5,465.75,51,64.5,"PRO"
1,22,35,14,476,51,65,"PRO"
1,23,33.5,14.5,471.25,52,66.5,"PRO"
1,24,37,14,504,49,63,"PRO"
1,25,36,15,525,49,64,"PRO"
2,1,0,20,-20,80,100,"FLASH"
2,2,35,30,1020,35,65,"FLASH"
2,3,15,20,280,65,85,"FLASH"
2,4,48,10,470,42,52,"FLASH"
2,5,31,20,600,49,69,"FLASH"
2,6,49,10,480,41,51,"FLASH"
2,7,39,20,760,41,61,"FLASH"
2,8,41,20,800,39,59,"FLASH"
2,9,40,20,780,40,60,"FLASH"
2,10,37,20,720,43,63,"FLASH"
2,11,26,30,750,44,74,"FLASH"
2,12,49,10,480,41,51,"FLASH"
2,13,46,10,450,44,54,"FLASH"
2,14,41,10,400,49,59,"FLASH"
2,15,40,10,390,50,60,"FLASH"
2,16,40,10,390,50,60,"FLASH"
2,17,38,10,370,52,62,"FLASH"
2,18,37,10,360,53,63,"FLASH"
2,19,34,10,330,56,66,"FLASH"
2,20,39,10,380,51,61,"FLASH"
2,21,35.5,10,345,54.5,64.5,"FLASH"
2,22,35,10,340,55,65,"FLASH"
2,23,33.5,10,325,56.5,66.5,"FLASH"
2,24,37,10,360,53,63,"FLASH"
2,25,36,10,350,54,64,"FLASH"
3,1,0,20,-20,80,100,"PRO"
3,2,35,10,340,55,65,"PRO"
3,3,15,20,280,65,85,"PRO"
3,4,48,15,705,37,52,"PRO"
3,5,31,12,360,57,69,"PRO"
3,6,49,13,624,38,51,"PRO"
3,7,39,14,532,47,61,"PRO"
3,8,41,12,480,47,59,"PRO"
3,9,40,11,429,49,60,"PRO"
3,10,37,12,432,51,63,"PRO"
3,11,26,13,325,61,74,"PRO"
3,12,49,11,528,40,51,"PRO"
3,13,46,12,540,42,54,"PRO"
3,14,41,13,520,46,59,"PRO"
3,15,40,12,468,48,60,"PRO"
3,16,40,12,468,48,60,"PRO"
3,17,38,13,481,49,62,"PRO"
3,18,37,13,468,50,63,"PRO"
3,19,34,12,396,54,66,"PRO"
3,20,39,11,418,50,61,"PRO"
3,21,35.5,11,379.5,53.5,64.5,"PRO"
3,22,35,12,408,53,65,"PRO"
3,23,33.5,12,390,54.5,66.5,"PRO"
3,24,37,11,396,52,63,"PRO"
3,25,36,10,350,54,64,"PRO"
4,1,0,20,-20,80,100,"PRO"
4,2,35,5,170,60,65,"PRO"
4,3,15,15,210,70,85,"PRO"
4,4,48,10,470,42,52,"PRO"
4,5,31,12,360,57,69,"PRO"
4,6,49,8,384,43,51,"PRO"
4,7,39,6,228,55,61,"PRO"
4,8,41,10,400,49,59,"PRO"
4,9,40,9,351,51,60,"PRO"
4,10,37,11,396,52,63,"PRO"
4,11,26,10,250,64,74,"PRO"
4,12,49,12,576,39,51,"PRO"
4,13,46,12,540,42,54,"PRO"
4,14,41,14,560,45,59,"PRO"
4,15,40,16,624,44,60,"PRO"
4,16,40,16,624,44,60,"PRO"
4,17,38,17,629,45,62,"PRO"
4,18,37,18,648,45,63,"PRO"
4,19,34,19,627,47,66,"PRO"
4,20,39,18,684,43,61,"PRO"
4,21,35.5,19,655.5,45.5,64.5,"PRO"
4,22,35,17,578,48,65,"PRO"
4,23,33.5,18,585,48.5,66.5,"PRO"
4,24,37,17,612,46,63,"PRO"
4,25,36,17,595,47,64,"PRO"
5,1,0,20,-20,80,100,"PRO"
5,2,35,15,510,50,65,"PRO"
5,3,15,20,280,65,85,"PRO"
5,4,48,10,470,42,52,"PRO"
5,5,31,15,450,54,69,"PRO"
5,6,49,12,576,39,51,"PRO"
5,7,39,12,456,49,61,"PRO"
5,8,41,10,400,49,59,"PRO"
5,9,40,12,468,48,60,"PRO"
5,10,37,11,396,52,63,"PRO"
5,11,26,13,325,61,74,"PRO"
5,12,49,11,528,40,51,"PRO"
5,13,46,12,540,42,54,"PRO"
5,14,41,13,520,46,59,"PRO"
5,15,40,12,468,48,60,"PRO"
5,16,40,11,429,49,60,"PRO"
5,17,38,10,370,52,62,"PRO"
5,18,37,9,324,54,63,"PRO"
5,19,34,11,363,55,66,"PRO"
5,20,39,10,380,51,61,"PRO"
5,21,35.5,11,379.5,53.5,64.5,"PRO"
5,22,35,12,408,53,65,"PRO"
5,23,33.5,12,390,54.5,66.5,"PRO"
5,24,37,11,396,52,63,"PRO"
5,25,36,12,420,52,64,"PRO"
1,1,0,20,-20,85,105,"PRO"
1,2,55,5,270,40,45,"PRO"
1,3,41,10,400,49,59,"PRO"
1,4,28,15,405,57,72,"PRO"
1,5,36,12,420,52,64,"PRO"
1,6,28,13,351,59,72,"PRO"
1,7,34,11,363,55,66,"PRO"
1,8,26,10,250,64,74,"PRO"
1,9,34,12,396,54,66,"PRO"
1,10,33,12,384,55,67,"PRO"
1,11,33,12,384,55,67,"PRO"
1,12,34,12,396,54,66,"PRO"
1,13,34,13,429,53,66,"PRO"
1,14,36,14,490,50,64,"PRO"
1,15,32,15,465,53,68,"PRO"
1,16,34,14,462,52,66,"PRO"
1,17,36,13,455,51,64,"PRO"
1,18,32,14,434,54,68,"PRO"
1,19,36,13,455,51,64,"PRO"
1,20,35,14,476,51,65,"PRO"
1,21,31,15,450,54,69,"PRO"
1,22,36,14,490,50,64,"PRO"
1,23,37,13,468,50,63,"PRO"
1,24,31,14,420,55,69,"PRO"
1,25,33,15,480,52,67,"PRO"
2,1,0,25,-25,80,105,"FLASH"
2,2,55,20,1080,25,45,"FLASH"
2,3,41,15,600,44,59,"FLASH"
2,4,28,25,675,47,72,"FLASH"
2,5,36,30,1050,34,64,"FLASH"
2,6,28,30,810,42,72,"FLASH"
2,7,34,35,1155,31,66,"FLASH"
2,8,26,40,1000,34,74,"FLASH"
2,9,34,35,1155,31,66,"FLASH"
2,10,33,35,1120,32,67,"FLASH"
2,11,33,35,1120,32,67,"FLASH"
2,12,34,30,990,36,66,"FLASH"
2,13,34,25,825,41,66,"FLASH"
2,14,36,20,700,44,64,"FLASH"
2,15,32,20,620,48,68,"FLASH"
2,16,34,20,660,46,66,"FLASH"
2,17,36,20,700,44,64,"FLASH"
2,18,32,20,620,48,68,"FLASH"
2,19,36,20,700,44,64,"FLASH"
2,20,35,20,680,45,65,"FLASH"
2,21,31,20,600,49,69,"FLASH"
2,22,36,20,700,44,64,"FLASH"
2,23,37,20,720,43,63,"FLASH"
2,24,31,20,600,49,69,"FLASH"
2,25,33,20,640,47,67,"FLASH"
3,1,0,20,-20,85,105,"PRO"
3,2,55,10,540,35,45,"PRO"
3,3,41,15,600,44,59,"PRO"
3,4,28,20,540,52,72,"PRO"
3,5,36,12,420,52,64,"PRO"
3,6,28,15,405,57,72,"PRO"
3,7,34,10,330,56,66,"PRO"
3,8,26,12,300,62,74,"PRO"
3,9,34,10,330,56,66,"PRO"
3,10,33,10,320,57,67,"PRO"
3,11,33,8,256,59,67,"PRO"
3,12,34,12,396,54,66,"PRO"
3,13,34,14,462,52,66,"PRO"
3,14,36,14,490,50,64,"PRO"
3,15,32,15,465,53,68,"PRO"
3,16,34,14,462,52,66,"PRO"
3,17,36,13,455,51,64,"PRO"
3,18,32,14,434,54,68,"PRO"
3,19,36,13,455,51,64,"PRO"
3,20,35,12,408,53,65,"PRO"
3,21,31,13,390,56,69,"PRO"
3,22,36,12,420,52,64,"PRO"
3,23,37,12,432,51,63,"PRO"
3,24,31,13,390,56,69,"PRO"
3,25,33,12,384,55,67,"PRO"
4,1,0,20,-20,85,105,"PRO"
4,2,55,5,270,40,45,"PRO"
4,3,41,4,160,55,59,"PRO"
4,4,28,2,54,70,72,"PRO"
4,5,36,5,175,59,64,"PRO"
4,6,28,4,108,68,72,"PRO"
4,7,34,2,66,64,66,"PRO"
4,8,26,3,75,71,74,"PRO"
4,9,34,1,33,65,66,"PRO"
4,10,33,3,96,64,67,"PRO"
4,11,33,4,128,63,67,"PRO"
4,12,34,5,165,61,66,"PRO"
4,13,34,5,165,61,66,"PRO"
4,14,36,6,210,58,64,"PRO"
4,15,32,7,217,61,68,"PRO"
4,16,34,8,264,58,66,"PRO"
4,17,36,9,315,55,64,"PRO"
4,18,32,10,310,58,68,"PRO"
4,19,36,9,315,55,64,"PRO"
4,20,35,11,374,54,65,"PRO"
4,21,31,12,360,57,69,"PRO"
4,22,36,10,350,54,64,"PRO"
4,23,37,11,396,52,63,"PRO"
4,24,31,12,360,57,69,"PRO"
4,25,33,11,352,56,67,"PRO"
5,1,0,20,-20,85,105,"PRO"
5,2,55,5,270,40,45,"PRO"
5,3,41,15,600,44,59,"PRO"
5,4,28,10,270,62,72,"PRO"
5,5,36,5,175,59,64,"PRO"
5,6,28,10,270,62,72,"PRO"
5,7,34,8,264,58,66,"PRO"
5,8,26,9,225,65,74,"PRO"
5,9,34,8,264,58,66,"PRO"
5,10,33,7,224,60,67,"PRO"
5,11,33,8,256,59,67,"PRO"
5,12,34,7,231,59,66,"PRO"
5,13,34,9,297,57,66,"PRO"
5,14,36,10,350,54,64,"PRO"
5,15,32,11,341,57,68,"PRO"
5,16,34,10,330,56,66,"PRO"
5,17,36,9,315,55,64,"PRO"
5,18,32,10,310,58,68,"PRO"
5,19,36,9,315,55,64,"PRO"
5,20,35,8,272,57,65,"PRO"
5,21,31,9,270,60,69,"PRO"
5,22,36,8,280,56,64,"PRO"
5,23,37,7,252,56,63,"PRO"
5,24,31,10,300,59,69,"PRO"
5,25,33,9,288,58,67,"PRO"
